Brass	Trumpets, tubas, horns, and other things made of brass
Collection	Collection of different instruments
Collection:General MIDI	General MIDI (GM) instrument collection
Chromatic Percussion	Xylophone, glockenspiel, vibraphone and other percussive instruments with varied pitch
Effects	Sound effects
Ensemble	String ensembles, choir voices, orchestra hit and other grouped instrument sounds
Ethnic	Bag pipes, shamisen, sitar, didgeridoo and other instruments unique to an ethnic group
Guitar	General guitar sounds
Guitar:Bass	Bass guitar
Guitar:Electric	Electric guitar
Miscellaneous	Miscellaneous sounds not part of any other category
Organ	Pipe organ, electric organ, and other organ sounds
Percussion	Percussion sounds
Percussion:Kits	Percussion kit collections
Piano	Grand piano, electric piano, harpsichord and other piano like instrument sounds
Strings	Violins, cellos, harps, and other general string based instruments
Synth	Synthesized sounds
Synth:Analog	Analog synthesizer sounds
Synth:Bass	Bass synthesizer sounds
Synth:Effects	Synthesized sound effects
Synth:Lead	Lead synth
Synth:Pad	Synthesized pads
Wind	Flute, pan pipes, recorder, saxaphone, clarinet, and other wind instruments.
